#########################
#P         #            #
#          #            #
#       X  #            #
#                X    O #
#    X  O       #########
#                       #
#      X                #
#      #                #
#      #                #
#O     #O               #
#########################
