##########################
#        O               #
#   P                 X  #
#                        #
#######       X###########
#  O                     #
#  #                     #
#      #               OO#
#      XX     ############
#      #                 #
##########################