##########################
#        O               #
#   P.                X  #
#                     .  #
#######       X###########
#  O                     #
#  #         .           #
#      #               OO#
#      XX.    ############
#      #                B#
#           ##############
#            ... BBBBBBBB#
##########################