##############################
#    P            X        O #
#                            #
#                      .     #
#            X              O#
#O           #################
#     .                      #
#X                           #
#       B      X            O#
#                       .    #
#                      B     #
############################ #
#        B                   #
#                 X         O#
##############################