########################################
#        O         #                   #
#   P              #  X                #
#                  #                   #
#######       X##########          O   #
#  O                    O  #############
#  #                                X  #
#      #                O              #
#      XX     ###########              #
#      #               X            O  #
########################################